{
  "tiles" : [ [2, 2, 2, 2, 2, 2, 2, 2 ],
              [2, 1, 1, 1, 1, 1, 1, 2 ],
              [2, 1, 1, 1, 1, 1, 1, 2 ],
              [2, 1, 1, 1, 1, 1, 1, 2 ],
              [2, 2, 2, 2, 2, 2, 2, 2 ],
              [2, 1, 1, 1, 1, 1, 1, 2 ],
              [2, 1, 1, 1, 1, 1, 1, 2 ],
              [2, 1, 1, 1, 1, 1, 1, 2 ],
              [2, 1, 1, 1, 1, 1, 1, 2 ] ],

  "targetScore" : 1000,
  "moves" : 20,
}
