{
  "tiles" : [ [2, 1, 1, 1, 1, 1, 1, 0, 0 ],
              [1, 2, 1, 1, 1, 1, 1, 0, 0 ],
              [1, 1, 2, 1, 1, 1, 1, 1, 1 ],
              [1, 1, 1, 2, 1, 1, 1, 1, 1 ],
              [1, 1, 1, 1, 2, 1, 1, 1, 1 ],
              [1, 1, 1, 1, 1, 2, 1, 1, 1 ],
              [1, 1, 1, 1, 1, 1, 2, 1, 1 ],
              [0, 0, 1, 1, 1, 1, 1, 2, 1 ],
              [0, 0, 1, 1, 1, 1, 1, 1, 2 ] ],

  "moves" : 25,
  "levelGoal": {
      "firstStarScore": 800,
      "secondStarScore": 1500,
      "thirdStarScore": 2000,
      "levelTarget": {
          "dumpling": 20,
          "bowl": 18
      }
  }
}
