{
  "tiles" : [ [1, 1, 1, 1, 1, 1, 1, 1, 1 ],
              [1, 1, 1, 0, 0, 0, 1, 1, 1 ],
              [1, 1, 1, 0, 0, 0, 1, 1, 1 ],
              [1, 1, 1, 1, 1, 1, 1, 1, 1 ],
              [1, 1, 1, 1, 1, 1, 1, 1, 1 ],
              [1, 1, 1, 1, 1, 1, 1, 1, 1 ],
              [1, 1, 1, 0, 0, 0, 1, 1, 1 ],
              [1, 1, 1, 0, 0, 0, 1, 1, 1 ],
              [1, 1, 1, 1, 1, 1, 1, 1, 1 ] ],

  "moves" : 25,
  "levelGoal": {
      "firstStarScore": 800,
      "secondStarScore": 1500,
      "thirdStarScore": 2000,
      "levelTarget": {
          "zodiac": 18,
          "redPocket": 15
      }
  }
}
