{
  "tiles" : [ [1, 1, 1, 1, 1, 1, 1, 1, 1 ],
              [1, 1, 1, 1, 1, 1, 1, 1, 1 ],
              [1, 1, 1, 1, 1, 1, 1, 1, 1 ],
              [1, 1, 2, 1, 2, 1, 2, 1, 1 ],
              [1, 2, 2, 2, 2, 2, 2, 2, 1 ],
              [1, 1, 2, 1, 2, 1, 2, 1, 1 ],
              [1, 1, 1, 1, 1, 1, 1, 1, 1 ],
              [1, 1, 1, 1, 1, 1, 1, 1, 1 ],
              [1, 1, 1, 1, 1, 1, 1, 1, 1 ] ],

  "moves" : 20,
  "levelGoal": {
      "firstStarScore": 500,
      "secondStarScore": 800,
      "thirdStarScore": 1200,
      "levelTarget": {
          "redPocket": 10
      }
  }
}
