{
  "tiles" : [ [0, 1, 1, 1, 1, 1, 1, 1, 0],
              [0, 1, 1, 1, 1, 1, 1, 1, 0],
              [1, 1, 1, 1, 1, 1, 1, 1, 1 ],
              [1, 1, 1, 2, 2, 2, 1, 1, 1 ],
              [1, 1, 1, 2, 2, 2, 1, 1, 1 ],
              [1, 1, 1, 2, 2, 2, 1, 1, 1 ],
              [1, 1, 1, 1, 1, 1, 1, 1, 1 ],
              [0, 1, 1, 1, 1, 1, 1, 1, 0 ],
              [0, 1, 1, 1, 1, 1, 1, 1, 0 ] ],

  "moves" : 25,
  "levelGoal": {
      "firstStarScore": 800,
      "secondStarScore": 1300,
      "thirdStarScore": 2000,
      "levelTarget": {
          "dumpling": 15,
          "firecracker": 20
          
      }
  }
}
