{
  "tiles" : [ [2, 2, 1, 1, 1, 1, 1, 2, 2 ],
              [2, 2, 1, 1, 1, 1, 1, 2, 2 ],
              [2, 2, 1, 1, 1, 1, 1, 2, 2 ],
              [1, 1, 1, 1, 1, 1, 1, 1, 1 ],
              [1, 1, 1, 1, 1, 1, 1, 1, 1 ],
              [1, 1, 1, 1, 1, 1, 1, 1, 1 ],
              [2, 2, 1, 1, 1, 1, 1, 2, 2 ],
              [2, 2, 1, 1, 1, 1, 1, 2, 2 ],
              [2, 2, 1, 1, 1, 1, 1, 2, 2 ] ],

  "moves" : 23,
  "levelGoal": {
      "firstStarScore": 700,
      "secondStarScore": 1200,
      "thirdStarScore": 1800,
      "levelTarget": {
          "redPocket": 20
      }
  }
}
