{
  "tiles" : [ [0, 1, 1, 1, 0, 1, 1, 1, 0 ],
              [1, 1, 1, 1, 1, 1, 1, 1, 1 ],
              [1, 0, 1, 1, 1, 1, 1, 0, 1 ],
              [1, 0, 1, 1, 1, 1, 1, 0, 1 ],
              [1, 0, 1, 1, 1, 1, 1, 0, 1 ],
              [1, 0, 1, 1, 1, 1, 1, 0, 1 ],
              [1, 1, 1, 1, 1, 1, 1, 1, 1 ],
              [1, 1, 1, 1, 1, 1, 1, 1, 1 ]],

  "moves" : 23,
  "levelGoal": {
      "firstStarScore": 700,
      "secondStarScore": 1200,
      "thirdStarScore": 1800,
      "levelTarget": {
          "zodiac": 12,
          "redPocket": 10
      }
  }
}
