{
  "tiles" : [ [1, 1, 1, 1, 1, 1, 1, 1, 1],
              [1, 1, 1, 1, 1, 1, 1, 1, 1],
              [1, 1, 1, 1, 2, 1, 1, 1, 1 ],
              [1, 1, 1, 1, 2, 1, 1, 1, 1 ],
              [1, 1, 2, 2, 2, 2, 2, 1, 1 ],
              [1, 1, 1, 1, 2, 1, 1, 1, 1 ],
              [1, 1, 1, 1, 2, 1, 1, 1, 1 ],
              [1, 1, 1, 1, 1, 1, 1, 1, 1 ],
              [1, 1, 1, 1, 1, 1, 1, 1, 1 ] ],

  "moves" : 25,
  "levelGoal": {
      "firstStarScore": 800,
      "secondStarScore": 1300,
      "thirdStarScore": 2000,
      "levelTarget": {
          "zodiac": 22
      }
  }
}
