{
  "tiles" : [ [1, 1, 1, 1, 1, 1, 1, 1, 1 ],
              [1, 1, 1, 1, 1, 1, 1, 1, 1 ],
              [1, 1, 1, 1, 1, 1, 1, 1, 1 ],
              [1, 0, 0, 0, 0, 0, 0, 0, 1 ],
              [1, 0, 0, 0, 0, 0, 0, 0, 1 ],
              [1, 0, 0, 0, 0, 0, 0, 0, 1 ],
              [1, 1, 1, 1, 1, 1, 1, 1, 1 ],
              [1, 1, 1, 1, 1, 1, 1, 1, 1 ],
              [1, 1, 1, 1, 1, 1, 1, 1, 1 ] ],

  "moves" : 12,
  "levelGoal": {
      "firstStarScore": 500,
      "secondStarScore": 800,
      "thirdStarScore": 1200,
      "levelTarget": {
          "zodiac": 20
      }
  }
}
