{
  "tiles" : [ [1, 1, 1, 1, 1, 1, 1, 1, 1 ],
              [1, 1, 1, 1, 1, 1, 1, 1, 1 ],
              [1, 1, 1, 1, 1, 1, 1, 1, 1 ],
              [1, 0, 1, 0, 1, 0, 1, 0, 1 ],
              [1, 2, 2, 2, 2, 2, 2, 2, 1 ],
              [1, 0, 1, 0, 1, 0, 1, 0, 1 ],
              [1, 1, 1, 1, 1, 1, 1, 1, 1 ],
              [1, 1, 1, 1, 1, 1, 1, 1, 1 ],
              [1, 1, 1, 1, 1, 1, 1, 1, 1 ] ],

  "moves" : 25,
  "levelGoal": {
      "firstStarScore": 900,
      "secondStarScore": 1600,
      "thirdStarScore": 2100,
      "levelTarget": {
          "zodiac": 20,
          "redPocket": 10,
          "dumpling": 15
      }
  }
}
