{
  "tiles" : [ [0, 0, 1, 1, 1, 1, 1, 0, 0],
              [0, 0, 1, 1, 1, 1, 1, 0, 0],
              [1, 1, 1, 1, 1, 1, 1, 1, 1 ],
              [1, 1, 1, 1, 1, 1, 1, 1, 1 ],
              [1, 1, 1, 1, 1, 1, 1, 1, 1 ],
              [1, 1, 1, 1, 1, 1, 1, 1, 1 ],
              [1, 1, 1, 1, 1, 1, 1, 1, 1 ],
              [0, 0, 1, 1, 1, 1, 1, 0, 0 ],
              [0, 0, 1, 1, 1, 1, 1, 0, 0 ] ],

  "targetScore" : 1500,
  "moves" : 20,
}
